13 8

*S*.**.*
*...*.*.
**..*..*
***.**.*
***....*
**.**..*
**...*.*
...***.*
.*.**..*
.*....**
.*******
..******
*......D